B	B IY
B-PRIME	B IY P R AY M
B-TWO	B IY T UW
CORNER-PERMUTATION	K AO R N ER P ER M Y UW T EY SH AH N
DOWN	D AW N
DOWN-PRIME	D AW N P R AY M
DOWN-TWO	D AW N T UW
EDGE-PERMUTATION	EH JH P ER M Y UW T EY SH AH N
F	EH F
F-PRIME	EH F P R AY M
F-TWO	EH F T UW
GOOD-T	G UH D T IY
H	EY CH
H-PRIME	EY CH P R AY M
K	K EY
K-PRIME	K EY P R AY M
L	EH L
L-PRIME	EH L P R AY M
L-TRIGGER	EH L T R IH G ER
L-TWO	EH L T UW
LEFT-INVERSE-TRIGGER	L EH F T IH N V ER S T R IH G ER
LEFT-SOON	L EH F T S UW N
LEFT-TRIGGER	L EH F T T R IH G ER
OOPS	UW P S
R	AA R
R-PRIME	AA R P R AY M
R-TRIGGER	AA R T R IH G ER
R-TWO	AA R T UW
RIGHT-INVERSE-TRIGGER	R AY T IH N V ER S T R IH G ER
RIGHT-SOON	R AY T S UW N
RIGHT-TRIGGER	R AY T T R IH G ER
SCRAMBLE	S K R AE M B AH L
SHIT	SH IH T
T-PERMUTATION	T IY P ER M Y UW T EY SH AH N
U	Y UW
U-PRIME	Y UW P R AY M
U-TWO	Y UW T UW
UNDO	AH N D UW
X	EH K S
X-PRIME	EH K S P R AY M
X-TWO	EH K S T UW
Y	W AY
Y-PRIME	W AY P R AY M
Y-TWO	W AY T UW
Z	Z IY
Z-PRIME	Z IY P R AY M
Z-TWO	Z IY T UW
